XXXXXXXXXXXXXXlXXXXX
Xc            l  c X
X         X        X
XX    X    X    XXXX
X c           lX   X
X X      XXX  l    X
X                  X
X   XXX  c       c X
Xi            l    X
XXXXXXXXXXXXXXlXXXXX