XXXXXXXXXXXXXXlXXXXX
Xc            l  c X
XXXX      XX  l    X
X     X         XXXX
X c           lX   X
X X      XXX  l    X
X             l    X
X   XXX          c X
Xi            l    X
XXXXXXXXXXXXXXlXXXXX