XXXXXXXXXXXXXXXXXXXX
Xc       c         X
X                  X
XXXX      X      c X
X   X  X           X
X             XX   X
X         X        X
X     XX           X
Xic              c X
XXXXlllllXXXllllXXXX