XXXXXXXXXXXXXXXXXXXX
Xl                 X
XXXX               X
X       XXX        X
X                  X
X             XX   X
X         X        X
X     XX           X
Xi                 X
XXXX     XXX    XXXX