XXXXXXXXXXXXXXXXXXXX
Xc       c         X
XXXX               X
X   X   XXX      c X
X                  X
X             XX   X
X         X        X
X     XX           X
Xic              c X
XXXXlllllXXXllllXXXX