XXXXXXXXXXXXXXlXXXXX
Xc            l  c X
X         XX  l    X
XX    X         XXXX
X c           lX   X
X X      XXX  l    X
X                  X
X   XXX          c X
Xic           l    X
XXXXXXXXXXXXXXlXXXXX